вздыхать и думать про себя	Вздыхать и думать про себя:
его пример другим наука	Его пример другим наука;
ему подушки поправлять	Ему подушки поправлять,
и лучше выдумать не мог	И лучше выдумать не мог.
какое низкое коварство	Какое низкое коварство
когда же черт возьмет тебя	Когда же черт возьмет тебя!
когда не в шутку занемог	Когда не в шутку занемог,
мой дядя самых честных правил	Мой дядя самых честных правил,
не отходя ни шагу прочь	Не отходя ни шагу прочь!
но боже мой какая скука	Но, боже мой, какая скука
он уважать себя заставил	Он уважать себя заставил
печально подносить лекарство	Печально подносить лекарство,
полуживого забавлять	Полуживого забавлять,
с больным сидеть и день и ночь	С больным сидеть и день и ночь,

акуан мигурд ремирп оге	Его пример другим наука;
акукс яакак йом ежоб он	Но, боже мой, какая скука
гом ен ьтамудыв ешчул и	И лучше выдумать не мог.
гоменаз уктуш в ен адгок	Когда не в шутку занемог,
ливарп хынтсеч хымас ядяд йом	Мой дядя самых честных правил,
ливатсаз ябес ьтажаву но	Он уважать себя заставил
овтсравок еокзин еокак	Какое низкое коварство
овтсракел ьтисондоп оньлачеп	Печально подносить лекарство,
ьтялвабаз оговижулоп	Полуживого забавлять,
ьтялварпоп икшудоп уме	Ему подушки поправлять,
ьчон и ьнед и ьтедис мыньлоб с	С больным сидеть и день и ночь,
ьчорп угаш ин ядохто ен	Не отходя ни шагу прочь!
ябес орп ьтамуд и ьтахыдзв	Вздыхать и думать про себя:
ябет темьзов треч еж адгок	Когда же черт возьмет тебя!

